SE.##....T
#T##..###.
#.###E###E
#.E...###S
###T#####G
